brate	antue
Apfel	starr
lagre	nennt
Dorne	ledig
eilte	ekeln
Tasse	Jacks
Wrack	Login
Oskar	Yetis
wehre	Pizza
spiet	Speck
moste	Opern
impfe	raten
bergt	GByte
herum	Photo
Laube	essen
loben	welle
Wiese	Kurse
tutet	wrang
behob	tramp
Motor	Juwel
kurte	meide
Holme	patze
Pulte	Buchs
Ruins	Hymne
Halls	Chips
kalte	Getue
bewog	vager
Olafs	Zaums
Kulis	Tutor
tafle	Bilds
zupft	Leber
Pasta	werbt
arten	hofft
locht	garer
heran	Erlen
einer	Reset
James	Garne
stell	Poker
Rates	Pille
kling	Hirte
wohle	Wille
Sushi	sinke
Darms	Winds
toben	Zange
Bruch	Zopfs
badet	klipp
Hedda	Zobel
Gurts	linkt
bahnt	umtut
affig	belog
Mixer	irrer
rangt	edlem
Datum	grabe
Stich	somit
Tests	Mimik
vages	zirka
links	Borke
angle	Garbo
enden	wahrt
Brote	zwick
ablag	Nutte
spien	atmen
Tatze	Miliz
stark	Becks
Inkas	Nervs
lieht	mutet
Skats	Leibs
Kiste	Khans
rudre	blass
Serum	Parts
Tegel	Hubes
Wucht	Grube
Nabel	Bauer
Firma	atmet
Gifts	guten
Urins	Strom
kniff	Kiosk
Plato	Gummi
Zauns	Efeus
Depot	Lotes
rosig	engst
Index	Anker
beben	kaufe
Joker	liefe
Grads	LaTeX
igele	Mitte
summe	Angel
Regel	Spott
Akten	Lasso
Ticks	Heidi
ficke	Zwerg
Gramm	riefe
zweit	Hauff
reich	frage
Areal	Slips
Ekels	ducke
Safes	steif
unken	Wurms
Siebs	walle
Husar	Insel
